#tiles
xxxxxxxxxxxxxxxxxxxxxxx
x.....................x
x.....................x
x.....................x
x.....................x
x.....................x
x.....................x
x.............xxx.....x
x..................xx.x
x...../xx\............x
xxxxxxxxxxxxxxxxxxxxxxx